E-Commerce	NP
EU	NP
European	NP
I	NP
Internet	NP
Market	NP
Mrs.	NP
Plan	NP
Providers	NP
Service	NP
a	DT
about	RB
above	RB
absolute	JJ
absolutely	RB
access	NN
accessible	JJ
accord	NN
according	VBG
acknowledgement	NN
across	IN
act	NN
action	NN
additional	JJ
adept	NN
adequate	JJ
admission	NN
adopted	VBD
advance	NN
advantage	NN
affect	VB
after	IN
again	RB
agreement	NN
all	DT
all	RB
also	RB
am	VBP
amendment	NN
an	DT
and	CC
another	DT
appeal	NN
application	NN
apply	VBP
are	NN
argue	VBP
army	NN
arouse	VB
arrive	VB
artifacts	NNS
as	IN
as	RB
ask	VB
asset	NN
assurance	NN
assuredly	RB
at	IN
authorize	VB
authorized	JJ
available	JJ
back	NN
balance	NN
bare	JJ
bark	NN
barking	VBG
be	VB
became	VBD
because	RB
become	VB
below	IN
beneath	IN
benefit	NN
besides	IN
bet	NN
better	JJR
between	IN
big	JJ
bolt	NN
bounds	NNS
bring	VBP
broadband	NN
business	NN
but	CC
by	IN
can	VBP
careful	JJ
carefully	RB
carry	VB
carry	VBP
case	NN
cause	VB
cent	NN
certain	JJ
certainly	RB
certainty	NN
chance	NN
check	NN
clean	VB
clear	JJ
clearly	RB
collaborate	VBP
come	VB
come	VBN
comma	NN
commerce	NN
commercial	JJ
commission	NN
commodity	NN
common	JJ
community	NN
companies	NNS
company	NN
completely	RB
compose	VB
computer	NN
computers	NNS
concern	NN
concluded	VBD
conclusion	NN
conclusive	JJ
conduct	NN
confession	NN
confidence	NN
consider	VBP
consideration	NN
consistent	JJ
consumer	NN
contact	NN
contain	VBP
continue	VB
contract	NN
contracts	NNS
cooperate	VB
copying	NN
cover	VB
create	VB
crossborder	NN
cultural	JJ
custom	NN
data	NNS
debate	NN
decision	NN
decisive	JJ
decisively	RB
defence	NN
defend	VB
defended	VBD
definitely	RB
delight	VB
design	NN
desire	NN
determined	VBD
develop	VB
development	NN
dialogue	NN
directive	NN
directives	NNS
discuss	VB
distance	NN
divide	VBP
do	VB
document	NN
domiciled	VBD
down	RB
dry	VB
during	IN
duty	NN
dynamic	JJ
e-initiative	NP
eat	VBP
economy	NN
education	NN
effect	NN
ego	NN
electronic	JJ
employ	NN
employment	NN
engender	VBP
engineer	NN
enterprise	NN
entitle	VB
entitled	VBN
establish	VBP
etc.	NN
europe	NN
even	RB
ever	RB
every	DT
everybody	NN
everyone	NN
exactly	RB
example	NN
excellent	JJ
excellently	RB
except	IN
exception	NN
exempt	JJ
faith	NN
faster	JJR
favour	NN
few	JJ
fine	NN
first	RB
following	VBG
for	IN
force	VBP
foreign-based	JJ
foremost	JJ
form	NN
former	JJ
forth	RB
forward	JJ
forward	RB
found	VBN
from	IN
front	NN
function	NN
further	JJR
future	NN
gave	VBD
general	NN
generally	RB
get	VBP
give	VB
global	JJ
go	NN
going	VBG
good	JJ
goods	NNS
got	VBD
grab	VB
great	JJ
group	NN
grow	VB
guarantee	NN
harmonise	VB
have	VBP
he	PP
head	VBP
her	PP
here	RB
hinder	VB
his	PP$
host	NN
how	WRB
husband	NN
if	IN
immaterial	JJ
implementing	VBG
improve	VB
in	IN
including	VBG
industry	NN
influence	NN
inhabitants	NNS
inner	JJ
inside	IN
instruction	NN
instruments	NNS
insurance	NN
interest	NN
interested	JJ
interior	JJ
internal	JJ
internet	NN
internet-based	JJ
interrupt	VBP
into	IN
introduce	VB
is	VBZ
it	PP
its	PP$
job	NN
juniper	NN
just	RB
justified	VBN
keep	VBP
know	VB
labour	VB
laptop	JJ
large	JJ
last	JJ
later	RBR
law	NN
lawful	JJ
lay	VB
lead	JJ
legal	JJ
legible	JJ
legislation	NN
legitimate	JJ
liability	NN
like	IN
limitation	NN
list	NN
look	NN
made	VBD
main	JJ
mainly	RB
make	VB
make	VBP
man	NN
mane	NN
manner	NN
market	NN
matter	NN
may	MD
me	PP
measure	VB
member	NN
merely	RB
mine	VBP
more	JJR
more	RBR
mould	NN
must	MD
my	PP$
myself	PP
naked	JJ
near	IN
necessary	JJ
necessity	NN
need	MD
need	VB
net	JJ
new	JJ
next	JJ
nn	NNS
nn	VBZ
not	RB
notice	VBP
nourish	VB
now	RB
number	NN
occupy	VB
odd	JJ
of	IN
off	RB
on	IN
on	RB
one	CD
online	JJ
only	RB
open	VBP
other	JJ
ought	MD
our	PP$
out	RB
outlet	NN
outside	NN
over	IN
own	JJ
part	NN
partake	VB
past	JJ
payment	NN
peculiar	JJ
people	NNS
per	IN
perceive	VBP
perform	VB
person	NN
pertain	VB
place	VB
plant	NN
play	NN
please	VBP
pleasure	NN
population	NN
portable	JJ
position	NN
possess	VBP
possibility	NN
possible	JJ
post	NN
present	NN
preserve	VB
prevent	VB
primary	JJ
private	JJ
probably	RB
procedures	NNS
produce	VB
product	NN
programs	NNS
progress	NN
promote	VBP
prompt	VB
proposal	NN
protect	VB
protection	NN
protective	JJ
provided	VBN
public	JJ
pure	JJ
put	NN
put	VBD
qualifications	NNS
quantity	NN
queer	NN
question	NN
quite	RB
re-	NN
reasonable	JJ
receive	VBP
recognition	NN
regard	NN
registration	NN
reinforce	VBP
require	VB
resolute	JJ
respect	NN
responsibility	NN
restrain	VB
restriction	NN
right	NN
rightful	JJ
rise	NN
room	NN
round	NN
rule	NN
run	VB
run	VBN
runner	NN
r√¥le	NN
safety	NN
said	VBD
sales	NNS
say	VB
sby	NP
scientific	JJ
scope	NN
scrutiny	NN
second	JJ
secure	JJ
secured	JJ
security	NN
see	VBP
seeing	VBG
sensible	JJ
serve	NN
service	NN
session	NN
set	NN
set	VB
set	VBD
settlement	NN
shall	MD
shape	VB
she	PP
shelter	NN
shop	NN
short	JJ
should	MD
simplify	VB
since	IN
slip	NN
so	RB
socket	NN
sow	VBP
speak	VB
special	JJ
specified	JJ
spring	NN
stake	NN
standardize	VB
starch	NN
start	NN
steady	RB
still	RB
stimulate	VB
storage	NN
stores	NNS
strange	JJ
strasbourg	NN
strategy	NN
strengthen	VB
stress	NN
structures	NNS
such	JJ
supply	NN
support	NN
supporting	VBG
survey	NN
system	NN
take	VB
tax	NN
technical	JJ
technician	NN
than	IN
thanks	NNS
that	DT
that	IN
the	DT
theirs	PP
them	PP
these	DT
third	JJ
this	NN
through	IN
thus	RB
to	TO
together	RB
too	RB
tool	NN
touch	NN
trade	NN
trading	NN
training	NN
transport	NN
travel	NN
trend	NN
trust	NN
two	CD
type	NN
ule	NNS
unanimous	JJ
under	IN
undertake	VB
undertaking	VBG
union	NN
until	IN
up	IN
up	RP
us	PP
usage	NN
use	NN
users	NNS
utilize	VBP
vague	JJ
valid	JJ
venture	NN
via	IN
view	NN
want	VBP
warranty	NN
was	VBD
wash	NN
watch	NN
way	NN
we	PP
wear	VBP
well	RB
were	VBD
what	WP
when	IN
where	WRB
which	WDT
who	WP
whole	JJ
whom	WP
wide	JJ
wife	NN
will	MD
wish	VB
with	IN
withhold	VB
within	IN
without	IN
wonder	NN
work	NN
world	NN
year	NN
yet	RB
you	PP
